=====================
=================T=#=
=================-=-=
=================---=
=================.===
=================-===
=================-===
===========--.----===
===========-=====-===
===========-=====-===
=========---=====.===
=========-=======-===
=========.======--===
=========-====---====
=========---.--======
=====-.---===========
====--===============
===.-================
===-=================
=#--=================
=====================
