.....................
.===================.
.=.................=.
.=...........=====.=.
.=.........O.=---=.=.
.=.+++....+++X-#-=.=.
.=.+O+....+.T=---=.=.
.=.+++....+..=====.=.
.=..+.....+........=.
.=..+++++++........=.
.=.....+...........=.
.=.===.++......+++.=.
.=.=-=..+++....+++.=.
.=.=--=...+....+++.=.
.=.=---=..+.....+..=.
.=.=-O-X+++++++++..=.
.=.=---=T..........=.
.=.=====....O......=.
.=.................=.
.===================.
.....................