=====================
===---.---===========
=---=====----.-----==
=.================-==
=--.----===--.--==#==
=======-===-===-=====
=======-----===-==--=
=--.-==========--x-?=
=-==----.---.---==--=
=--.-================
=-===================
=-----.----==---=====
==========-==-?-=====
==========-==---=====
===---.----===X======
===-==========-======
===-==========-======
===-----.-------.---=
===================-=
=============#------=
=====================
