=====================
=-.-----.-=----.----=
=-=====-=-=.=======-=
=-=====T=-=-==---==-=
=-.-.-===.=-==-?-X--=
=====-===-=-==---==-=
=--==-===-=-=======.=
=#-X--=---=-==------=
=--====-===.==.======
=======.===-==------=
=======-===-=======-=
=---.---===-=======-=
=.=========-====-.--=
=-==--=====-====-====
=--X-?=====-====-====
=-==--=====.===-----=
=-=======---===.===.=
=-=======-=====-----=
=.=---.---========-==
=---========#-X-.--==
=====================
