=====================
===================#=
===================-=
===================-=
===================.=
===================-=
==========--.----.--=
==========-==========
==========.==========
==========-==========
==========-==========
==========.==========
==========-==========
==========-==========
==========-==========
==========.==========
==========-==========
==========-==========
==========-==========
==========#==========
=====================
