=====================
=-----=---===-?-===T=
=-===-=-#-===---===-=
=-===-=---====X====#=
=-===-==X=====-====-=
=-===-==-====--====-=
=-===------.--=====-=
=.=================.=
=-=----.----=----==-=
=-=-=======-=-?---X-=
=-=-=======-=----==-=
=-=-=======-=======-=
=-=----.--=----.----=
=-=======-===========
=.=======----.------=
=-=================-=
=-=--=-.-==========.=
=-=--=-=-==========-=
=-=--=-=-==--.--===-=
=---.--=----===--.--=
=====================