=====================
==================#==
=---.-------.------==
=-===================
=.===================
=-===================
=-===================
=.===================
=-=========---=======
=----.----X-?-=======
=-=========---=======
=-===================
=.===================
=-===================
=-===================
=.===================
=-===================
=-===================
=---.-------.-----===
=================#===
=====================
