=====================
=--------.---------#=
=-===================
=--------.----------=
===================-=
=--------.----------=
=-===================
=--------.----------=
===================-=
=--------.----------=
=-===================
=--------.----------=
===================-=
=--------.----------=
=-===================
=--------.----------=
===================-=
=--------.----------=
=-===================
=--------.---------#=
=====================
