=====================
==---====----.----#==
==-=-====-===========
==-=--.---===========
==.========---=======
==-========-?-=======
==-========---=======
==-=========X========
==-=========-========
==-=====--.----.--===
==-=====-========-===
==-=====.========-===
==-=====-========--T=
==-=====---.---==-===
==-===========-==-===
==-===========.==-===
==.===========-==.===
==-==-----.----==-===
==-==-===========-===
==----===========--#=
=====================
